Aa (architect)	Aa
Abel, King of Denmark	Abel, King of Denmark
Abel Ferreira	Abel Ferreira
Abel Gómez Moreno	Abel Gómez Moreno
Abel Miglietti	Abel Miglietti
Achille Casanova	Achille Casanova
Adolf Holzhaus	Adolf Holzhaus
Adonis (musician)	Adonis
Adonis (musician)	Adonis
Agustín de Iturbide y Green	Agustin de Iturbide y Green
Ainslie Roberts	Ainslie Roberts
Akhenaton (rapper)	Akhenaton
Alaina Johnson	Alaina Johnson
Alastair Martin	Alastair Martin
Albert, Duke of Schleswig-Holstein	Albert, Duke of Schleswig-Holstein
Albert, King of Sweden	Albert
Albert Casimir, Duke of Teschen	Albert of Saxony
Albert Hall (footballer, born 1918)	Albert Hall (footballer born 1918)
Albert N. Whiting	Albert N. Whiting
Albert VII, Archduke of Austria	Albert of Austria
Albert of Saxony	Albert of Saxony
Anders Franzén	Franzen
Andy Collins (artist)	Andy Collins
Angeli (cartoonist)	Angeli (cartoonist)
Annie Lee Moss	Annie Lee Moss
Anthony da Silva	Anthony Silva
Anthony da Silva	Anthony da Silva
Antonio Farnese, Duke of Parma	Antonio Farnese
Antonio Thomas (wrestler)	Antonio Thomas (wrestler)
Antonius Ariantho	Antonius Ariantho
Antônio Wilson Vieira Honório	Antonio
Antônio de Moura Carvalho	Antônio de Moura Carvalho
Archduchess Maria Magdalena of Austria (1689–1743)	Archduchess Maria Magdalena of Austria (1689–1743)
Ariadne (empress)	Ariadne
Art Smith (chef)	Art Smith (chef)
Arthur P. Jacobs	Arthur P. Jacobs
Arthur Roberts (physicist)	Arthur Roberts (physicist)
Arthur W. Murray	Arthur W. Murray
Aspekt	Aspekt
Asser	Asser
Atlantis (wrestler)	Atlantis
Augustine Ahinful	Augustine Ahinful
Augustine of Canterbury	Augustinus
Aziz (artist)	Aziz
B.G. (rapper)	B.G.
Benjamin Smoke	Benjamin Smoke
Bernard of Italy	Bernard of Italy
Bernard of Kilwinning	Bernard of Kilwinning
Bernard of Saxe-Weimar	Bernard of Saxe-Weimar
Bernardo Domínguez	Dominguez
Bernardo Fernandes da Silva	Bernardo Fernandes da Silva
Bernhard Jensen	Bernhard Jensen
Bert Bakker	Bert Bakker
Bertin	Bertin
Best (Portuguese footballer)	Best (Portuguese footballer)
Beth Phoenix	Phoenix
Bill Leyden	Bill Leyden
Billy Boy (wrestler)	Billy Boy
Bink (record producer)	Bink
Blake Richards	Blake Richards
Blake Williams	Bilko
Blake Williams (basketball)	Blake Williams
Boom (entertainer)	Boom
Boss (rapper)	Boss
Buff Bagwell	Buff Bagwell
Canaletto	Canaletto
Capitão (footballer)	Capitão (footballer)
Carey Wilson (writer)	Carey Wilson
Catherine King (radio broadcaster)	Catherine King
Christian, Duke of Saxe-Eisenberg	Christian, Duke of Saxe-Eisenberg
Christian, Prince-Elect of Denmark	Christian, Prince-Elect of Denmark
Christian Cage	Captain Charisma
Christian Cage	Christian
Christian Corrêa Dionisio	Christian Correa Dionisio
Christian Fernández Salas	Christian Fernandez Salas
Christian I, Elector of Saxony	Christian I
Christian IV of Denmark	Christian IV of Denmark
Christian I of Denmark	Christian I of Denmark
Christian Oliver	Christian Oliver
Christian VIII of Denmark	Christian VIII of Denmark
Christian VII of Denmark	Christian VII of Denmark
Christian VI of Denmark	Christian VI of Denmark
Christian V of Denmark	Christian V of Denmark
Christina, Queen of Sweden	Christina, Queen of Sweden
Clarence Mackay	Clarence Mackay
Cliff Norton	Cliff Norton
Colin George	Colin George
Connie Mulder	Connie Mulder
Constantina (empress)	Constantina (empress)
Corneille (singer)	Corneille
Cornelis Pronk	Cornelis Pronk
Corona (footballer)	Corona (footballer)
Crowbar (wrestler)	Crowbar
Cyril Mann	Cyril Mann
DJ Ajax	DJ Ajax
Dale Murray (musician)	Dale Murray
Damianus	Damianus
Daniele da Volterra	Daniele da Volterra
Dante (footballer)	Dante (footballer)
Dante Alighieri	Dante Alighieri
David Abraham Cheulkar	David Abraham Cheulkar
David Charles (Australian politician)	David Charles
David Charles (physician)	David Charles (physician)
David Evans (RAAF officer)	David Evans
David França Oliveira e Silva	David França Oliveira e Silva
David Pereira da Costa	David Pereira da Costa
Davy (Hampshire cricketer)	Davy (Hampshire cricketer)
Dawson (actor)	Dawson (pornographic actor)
Dean (rapper)	Dean
Dean Martin	Dean Martin
Dean Martin	Write to Me from Naples
Dean Martin (footballer, born 1957)	Dean Martin
Dean Martin (politician)	Dean Martin (politician)
Diego Mazquiarán	Diego Mazquiaran
Don Callis	Don Callis
Donatello	Donatello
Double (singer)	Double
Edgar Booth	Edgar Booth
Edna Mae Harris	Edna Mae Harris
Edward Peck Curtis	Edward Peck Curtis
Egotistico Fantastico	Egotistico Fantastico
Eldon Maquemba	Eldon
Elektra (wrestling)	Elektra
Elias Alves da Silva	Elias Alves da Silva
Elias Mendes Trindade	Elias Mendes Trindade
Elias Ribeiro de Oliveira	Elias Ribeiro de Oliveira
Eliezer Spiegel	Eliezer Spiegel
Elizabeth Miklosi	Elizabeth Miklosi
Emii	Emii
Emily Stevens (actress)	Emily Stevens (actress)
Ercole, Lord of Monaco	Ercole
Eric Guerin	Eric Guerin
Ernest, Count of Lippe-Biesterfeld	Ernest II, Count of Lippe-Biesterfeld
Fabricio Agosto Ramírez	Fabricio Ramirez
Ferdinand, Duke of Breisgau	Ferdinand, Duke of Breisgau
Ferdinand I, Holy Roman Emperor	Ferdinand I, Holy Roman Emperor
Ferdinand II, Archduke of Austria	Ferdinand II
Ferdinand II, Holy Roman Emperor	Ferdinand II
Ferdinand III, Grand Duke of Tuscany	Ferdinand III
Ferdinand III, Holy Roman Emperor	Ferdinand of Habsburg
Ferdinand II of León	Ferdinand II of León
Ferdinand II of Portugal	Ferdinand of Portugal
Ferdinand II of the Two Sicilies	Ferdinand II
Ferdinand I of Aragon	Ferdinand of Aragon
Ferdinand I of Naples	Ferdinand I of Naples
Ferdinand I of Portugal	Ferdinand I of Portugal
Ferdinand I of the Two Sicilies	Ferdinand III
Ferdinand VII of Spain	Ferdinand VII of Spain
Ferdinando II de' Medici, Grand Duke of Tuscany	Ferdinand II
Fernando Tobias de Carvalho	Fernando Tobias de Carvalho
Francis, Duke of Anjou	Francis
Francis, Duke of Saxe-Coburg-Saalfeld	Franz
Francis, Duke of Teck	Francis
Francis (footballer)	Francis
Francis Cook, 1st Viscount of Monserrate	Francis Cook, 1st Viscount of Monserrate
Francis García	Francis Garcia
Francis José da Silva	Francis José da Silva
Francis Richards (diplomat)	Francis Richards
Francisco Delgado Melo	Francisco Delgado Melo
Frank M. Smith, Jr.	Frank M. Smith
Frederick Muller	Frederick Muller
Frederik de Wit	Frederik de Wit
George Allen (American football coach)	George Allen
George Allen (U.S. politician)	George Allen (U.S. politician)
George Allen (footballer)	George Allen
George Allen (ice hockey)	George Allen (ice hockey)
George W. Taylor (professor)	George W. Taylor (professor)
Georges Rouget	Georges Rouget
Gerald Brom	Gerald Brom
Gerhard (cartoonist)	Gerhard
Germán Figueroa	Germán Figueroa
Gilberto da Silva Melo	Gilberto da Silva Melo
Giordano Bruno	Giordano Bruno
Godefroy de La Tour d'Auvergne	Godefroy de La Tour d'Auvergne
Gordon Fraser (actor)	Gordon Fraser (actor)
Gordon Fraser (footballer)	Gordon Fraser
Grant Williams	Grant Williams
Gustavo Breda Rodrigues	Gustavo Breda Rodrigues
Hans Christian	Hans Christian
Harris (rapper)	Harris
Heath (musician)	Heath
Helena (empress)	St. Helen
Helena (empress)	Helena of Byzantium
Helena (empress)	Helena of Constantinople
Hendrich Miller Meireles Bernardo	Hendrich Miller Meireles Bernardo
Henri Christophe	Christophe
Henrique da Silva Coutinho	Henrique da Silva Coutinho
Henry Ellis Harris	Henry Ellis Harris
Henry I, Margrave of the Saxon Ostmark	Henry I, Margrave of the Saxon Ostmark
Henry II, Duke of Lorraine	Henry II
Henry II, Holy Roman Emperor	Henry II, Holy Roman Emperor
Henry II, Landgrave of Hesse	Henry II, Landgrave of Hesse
Henry II, Margrave of Meissen	Henry II
Henry III of France	Henry III of France
Henry II of England	Cultural depictions of Henry II of England
Henry II of England	Henry II of England
Henry II of France	Henry II of France
Henry I of France	Henry I of France
Henry VII of England	Henry Tudor
Henry the Fowler	Henry I the Fowler
Henry the Fowler	Henry the Fowler
Henry the Lion	Henry XII
Hercule, Duke of Montbazon	Hercule, Duke of Montbazon
Hercules (chef)	Hercules (chef)
Hercules (wrestler)	Super Invader
Herman (Swaiko)	Herman (Swaiko)
Herman (bishop)	Herman (bishop)
Hermann Bauer	Hermann Bauer
Hermann Huppen	Hermann Huppen
Hermes Neves Soares	Hermes Neves Soares
Hermes Rodrigues Júnior	Junior
Hokusai	Hokusai
Howard E. Koch	Howard Koch
Hubert de Givenchy	Hubert de Givenchy
Humphrey, Duke of Gloucester	Humphrey of Lancaster, 1st Duke of Gloucester
Irene Doukaina Laskarina	Irene Doukaina Laskarina
Irene Komnene Doukaina	Irene Komnene Doukaina
Irene of Athens	Saint Irene
Irene of Larissa	Irene of Larissa
Isabella, Duchess of Lorraine	Isabella
Isabella d'Este, Duchess of Parma	Isabella d'Este
Isabella of Aragon, Countess of Urgell	Isabella of Aragon
Isabella of Aragon, Countess of Urgell	Isabella of Aragon
Isabella of Cyprus	Isabella of Cyprus
Isabella of Savoy	Isabella of Savoy
Israel (footballer)	Israel
Israel Delgado	Israel Delgado Andres
J.R. (musician)	J.R.
J. W. Marcel Gilbert	J. W. Marcel Gilbert
J (South Korean singer)	J (singer)
J (musician)	J
Jaak Boon	Jaak Boon
Jack Hogg	Jack Hogg
Jack Hogg (footballer, born 1931)	Jack Hogg (footballer born 1931)
Jack Stevens	Jack Stevens
Jacob Guay	Jacob Guay
Jacob van Campen	Van Kampen
James Adams (Massachusetts politician)	James Adams
James Cooper (Canadian politician)	James Cooper
James Johnston (Secretary of State)	James Johnston
Jan Bernd Bicker	Jan Bernd Bicker
Jan Janssen	Jan Janssen
Jay Johnson (ventriloquist)	Jay Johnson
Jean-François Delacroix	Jean-Francois
Jeff Farmer (wrestler)	Jeff Farmer
Jefferson Smith (politician)	Jefferson Smith
Jeremy Borash	Jeremy Borash
Jhonatan Bernardo	Mariano Bernardo
Joan du Plat Taylor	Joan du Plat Taylor
Job (comics)	Job
Johann Michael Hahn	Johann Michael Hahn
Johannes van den Bosch (chess player)	Johannes van den Bosch (chess player)
John B. Willett	John B. Willett
John C. Allen	John C. Allen
John Donald (Wisconsin politician)	John Donald (Wisconsin politician)
John H. Hoffman	John H. Hoffman
John Hogg	John Hogg
John Oponjo Benjamin	John Oponjo Benjamin
Johnson (composer)	Johnson (composer)
Jonas Jessue da Silva Júnior	Jonas Jessue da Silva Júnior
Jones Leandro	Jones Leandro
Joost van den Vondel	Joost van den Vondel
Joseph Bonnier de la Mosson	Joseph Bonnier de la Mosson
Joyce Symons	Joyce Symons
João Baptista Martins	Joao Martins
Judith Holofernes	Judith Holofernes
Judy Chamberlain	Judy Chamberlain
Jules Renard	Jules Renard
Julian (actor)	Julian (pornographic actor)
Julian (emperor)	Julian
Juliana of the Netherlands	Juliana of the Netherlands
Julien Frier	Julien Frier
Julius Weise	Julius Weise
Kam (rapper)	Kam (rapper)
Karl Arndt	Karl Arndt
Karl Werner (footballer)	Karl Werner
Kate Jacobs	Kate Jacobs
Kenneth Mitchell (politician)	Kenneth Mitchell (politician)
Krystyna Rokiczana	Christina Rokiczana
Lauren (footballer)	Lauren Etame Mayer
Laurie Davidson	Laurie Davidson
Leandro Alves da Cunha	Leandro Alves da Cunha
Leandro Mariano da Silva	Leandro Mariano da Silva
Leonardo André Pimenta Faria	Leonardo Andre Pimenta Faria
Leonardo da Vinci	Leonardo da Vinci
Leopold, Duke of Lorraine	Leopold, Duke of Lorraine
Leslie Roberts	Leslie Roberts
Lewis (baseball)	Lewis
Lewis (cat)	Lewis
Louis IV, Grand Duke of Hesse	Ludwig
Louis IV, Holy Roman Emperor	Louis IV, Holy Roman Emperor
Louis IV, Holy Roman Emperor	Schism of Louis of Bavaria
Louis V, Landgrave of Hesse-Darmstadt	Ludwig V
Louis VI, Landgrave of Hesse-Darmstadt	Louis VI, Landgrave of Hesse-Darmstadt
Louis V of France	Louis of France
Louis XIV of France	Louis of France
Louis XVII of France	Louis, Dauphin of France
Louis XVI of France	Louis of France
Louis XV of France	Louis of France
Lucebert	Lucebert
Luis Roberto García Toral	Luis Roberto Garcia Toral
Luís Romano de Madeira Melo	Luis Romano de Madeira Melo
Macula (footballer)	Macula
Magnus, Duke of Saxony	Magnus I
Magnus Olafsson	Magnus Olafsson
Mann (rapper)	Mann (rapper)
Marcian	Marcian
Marcán	Marcán
Maria, wife of Constantine V	Maria
Maria, wife of Ivan Vladislav	Maria, wife of Ivan Vladislav
Maria, wife of Leo III	Maria
Maria (Japanese singer)	Maria
Maria Asenina of Bulgaria	Maria Asenina of Bulgaria
Maria Franck	Maria Franck
Maria Gonzaga, Duchess of Montferrat	Maria Gonzaga
Maria Kanellis	Maria Kanellis
Maria Nalbandian	Nalbandian
Maria Palaiologina Kantakouzene	Maria Palaiologina Kantakouzene
Maria d'Este	Maria d'Este
Maria of Antioch	Maria of Antioch
Maria of Montferrat	Queen Mary
Marilyn Harris (actress)	Marilyn Harris (actress)
Marina, Princess of Naples	Marina
Mark Houghton	Mark Houghton
Martial	Martial
Martin (Hampshire cricketer)	Martin
Martin Hoberg Hedegaard	Martin Hoberg Hedegaard
Martina (empress)	Martina
Mary, Queen of Scots	Mary, Queen of Scots
Mary II of England	Cultural depictions of Mary II of England
Mary II of England	Queen Mary
Mary I of England	Queen Mary
Mary Stuart, Countess of Bute	Mary Stuart
Mary Stuart (actress)	Mary Stuart
Matt Bloom	A Train
Max Winter	Max Winter
Maximilian I, Elector of Bavaria	Maximilian I of Bavaria
Maximilian I, Holy Roman Emperor	Emperor Maximilian
Maximum Capacity	Maximum Capacity
May (singer)	May (singer)
Menasseh Ben Israel	Menasseh Ben Israel
Meyer Carlos de Camargo Júnior	Meyer Carlos de Camargo Júnior
Michael I of Romania	Angelica Kreuger
Michael I of Romania	Michael I of Romania
Michael I of Romania	Michael Kreuger
Michael North (professor)	Michael North
Michelangelo	Michelangelo
Michoel Fisher	Michael Fisher
Mieczyslaw Gruber	Gruber
Military career of Napoleon Bonaparte	Military career of Napoleon Bonaparte
Molière	Moliere
Montesquieu	Montesquieu
Morris (cartoonist)	Morris
Mozart Santos Batista Júnior	Mozart Junior
Myriam Montemayor Cruz	Myriam Montemayor Cruz
Müller (footballer)	Müller
Napoleon	Napoleon
Napoleon (actor)	Napoleon
Neneco Norton	Neneco Norton
Newton Santos de Oliveira	Newton Santos de Oliveira
Nicholas Harold Phillips	Nicholas Harold Phillips
Nicholas of Arbroath	Nicholas of Arbroath
Nilton Pereira Mendes	Nilton Pereira Mendes
Nora S. Unwin	Nora S. Unwin
ODB (wrestler)	ODB (wrestler)
Oliver Cuadrado Martín	Oliver Cuadrado Martin
Origen	Origen
Pandora (singer)	Pandora (singer)
Paris (rapper)	Paris (rapper)
Pascal Kondaponi	Pascal Kondaponi
Paul Brand	Paul Brand
Paul Brandt	Paul Brandt
Paul Hamlyn	Paul Hamlyn
Paul of Greece	Paul of Greece
Pee Wee Lambert	Pee Wee Lambert
Personal life of Cicero	Personal life of Marcus Tullius Cicero
Personal life of Leonardo da Vinci	Personal life of Leonardo da Vinci
Peter Meyer (footballer)	Peter Meyer
Peter von Hess	Peter von Hess
Petit (Portuguese footballer)	Petit (Portuguese footballer)
Philip, Landgrave of Hesse-Philippsthal	Philip, Landgrave of Hesse-Philippsthal
Philip I, Landgrave of Hesse	Philip I, Landgrave of Hesse
Philip II, Duke of Savoy	Philip II, Duke of Savoy
Philip II of Macedon	Philip II of Macedon
Philip I of Castile	Philip I of Castile
Philip I of France	Philippe I
Philip the Apostle	Philip the Apostle
Pierre-Henri Simon	Pierre-Henri Simon
Pierroth Jr.	Pierroth
Piers Baron (musician)	Piers Baron
Pope Agatho	Pope Agatho
Postumus	Postumus
Prince Francis, Count of Trapani	Prince Francis, Count of Trapani
Prince Hermann of Saxe-Weimar-Eisenach (1886–1964)	Prince Hermann of Saxe-Weimar-Eisenach
Prince Napoléon Bonaparte	Napoléon Joseph Charles Paul Bonaparte
Prince Napoléon Bonaparte	Napoleon
Princess Maria of Romania (1870–1874)	Princess Maria of Romania (1870-1874)
Queen Emma of Hawaii	Emma
R. K. (actor)	R. K.
Raphael	Raphael
Raphael (singer)	Raphael
Raphael Tessaro Schettino	Raphael Tessaro Schettino
Ricardo (footballer, born 1971)	Ricardo López
Ricardo (footballer, born 1971)	Ricardo López Felipe
Ricardo (footballer, born 1976)	Ricardo
Ricardo (footballer, born 1976)	Ricardo Pereira
Ricardo (footballer, born 1980)	Ricardo (footballer, born 1980)
Ricardo (footballer, born 1980)	Ricardo Jorge Ferreira Pinto da Silva
Ricardo Job Estévão	Estevao
Ricardo Job Estévão	Estevao
Ricardo León Brito	Ricardo Leon Brito
Ricardo Rocha (Brazilian footballer, born 1965)	Ricardo Cordeiro da Rocha
Ricardo Teixeira Vieira	Ricardo Teixeira Vieira
Ricardo Valter da Costa	Ricardo Valter da Costa
Richard E. Wagner	Richard E. Wagner
Richard II, Duke of Normandy	Richard II, Duke of Normandy
Richard III, Duke of Normandy	Richard III
Richard III of England	Richard III of England
Richard II of England	Richard II of England
Richard Wagner (novelist)	Richard Wagner
Rico Suave (wrestler)	Julio Estrada (wrestler)
Robert, Archduke of Austria-Este	Robert, Archduke of Austria-Este
Robert, King of Naples	Robert
Robert (singer)	Robert (singer)
Robert Benjamin	Robert Benjamin
Robert Huber	Robert Huber
Robert I, Prior of St Andrews	Robert I, Prior of St Andrews
Robert II (bishop of Ross)	Robert II
Robert Pereira da Silva	Robert Pereira da Silva
Robert de Pinho de Souza	Robert
Robert of Bath	Robert of Bath
Roberto Alcântara Ballesteros	Roberto Alcantara Ballesteros
Roberto Andrade Silva	Roberto Andrade Silva
Roberto Calmon Félix	Roberto Calmon Félix
Roberto Fernández Alvarellos	Roberto Fernandez Alvarellos
Roberto Fernández Bonillo	Roberto Fernández Bonillo
Roberto Fresnedoso	Roberto Fresnedoso
Roberto García Cabello	Roberto García
Roberto Gomes Júnior	Junior
Roberto Jiménez Gago	Roberto Jimenez Gago
Roberto Júlio de Figueiredo	Roberto Júlio de Figueiredo
Roberto Orlando Affonso Júnior	Roberto Junior
Roberto Raviola	Roberto Raviola
Roberto Santamaría Calavia	Roberto Santamaria Calavia
Roberto Volpato	Roberto Volpato
Roberto de Sousa Rezende	Roberto de Sousa Rezende
Rodrigo Fernandes Valete	Rodrigo Fernandes Valete
Roger (larderer)	Roger
Roger Galera Flores	Roger Galera Flores
Roger García Junyent	Roger García Junyent
Roger Gaúcho	Roger Roberto dos Santos
Roger José de Noronha Silva	Roger Jose de Noronha Silva
Roger Machado Marques	Roger Machado Marques
Roger Rodrigues da Silva	Roger Rodrigues da Silva
Roger of Worcester	Roger
Ronald Wallace (politician)	Ronald Wallace
Rosamund Greenwood	Rosamund Greenwood
Rudolf II, Holy Roman Emperor	Rudolf II
Rudolf I of Bohemia	Rudolf I
Rudolf I of Germany	Rudolf I
Rudolf I of Germany	Rudolph I of Germany
Russell Hamilton	Russell Hamilton
Russell Smith (politician)	Russell Smith
Russell Smith (singer)	Russell Smith
Russell Smith (writer)	Russell Smith
Sailor Art Thomas	Sailor Art Thomas
Saint Pantaleon	Saint Pantaleon
Samuel Hunter Adams	Samuel Hunter Adams
Schwenck	Schwenck
Sebastiano del Piombo	Sebastiano
Shiba Kōkan	Shiba Kokan
Sidney Moraes	Sidney Moraes
Sidney Santos de Brito	Sidney Santos de Brito
Simon, Prior of St Andrews	Simon, Prior of St Andrews
Simon (cat)	Simon
Simon of Worcester	Simon of Worcester
Sir Francis Cook, 4th Baronet	Sir Francis Cook
Sivaji Ganesan	Sivaji Ganesan
Socrates	Socrates
Stephen Harris (painter)	Stephen Harris
Susan (Japanese singer)	Susan
Susan Cullen-Ward	Susan Cullen-Ward
Svein Koningen	Svein Koningen
Taylor Wilde	Shantelle Malawski
Taylor Wilde	Taylor Wilde
Thomas Arnold (bobsleigh)	Thomas Arnold (bobsleigh)
Thomas C. Cochran (historian)	Thomas C. Cochran
Thomas Reap	Thomas Reap
Tim (footballer)	Tim (footballer)
Tim (singer)	First Young Min
Tim (singer)	Tim
Titian	Titian
Tobias (bishop)	Tobias (bishop)
Tobin Wolf	Tobin Wolf
Tony da Costa Pinho	Tony da Costa Pinho
Vicar (cartoonist)	Vicar (comics)
Victorinus	Victorinus
Vincent de Bourbon, Count of Guingamp	Vincent de Bourbon, Count of Guingamp
Vincent van Gogh	Vincent van Gogh
Virgil (wrestler)	Michael Jones
Voltaire	Voltaire
Voltaire (musician)	Voltaire (musician)
Wagner Corrêa Machado	Wagner Corrêa Machado
Wallace Costa Alves	Wallace Costa Alves
Wallace Fernando Pereira	Wallace Fernando Pereira
Walter Babington Thomas	Walter Babington Thomas
Walter James (actor)	Walter James
Walter Schmidt (SS officer)	Walter Schmidt
Werner Winter	Werner Winter
Wilde Gomes da Silva	Wilde Gomes da Silva
Wilhelm Ernst	Wilhelm Ernst
Wilhelm II, German Emperor	Wilhelm II, German Emperor
Wilhelm II, German Emperor	Wilhelm II of Germany
Wilhelmina of the Netherlands	Wilhelmina of the Netherlands
Willard Myron Allen	Willard Myron Allen
Willard Waterman	Willard Waterman
William Close	William Close
William II, Elector of Hesse	Wilhelm II
William II, Landgrave of Hesse	Wilhelm II
William III of the Netherlands	William III
William II of Württemberg	William II of Württemberg
William II of the Netherlands	William II of the Netherlands
Willibrord	Willibrord
Wilson Constantino Novo Estrela	Wilson Constantino Novo Estrela
Wilson Roberto dos Santos	Wilson Roberto dos Santos
Wilson Rodrigues Fonseca	Wilson Rodrigues Fonseca
Wilson Rodrigues de Moura Júnior	Wilson Rodrigues de Moura Júnior
Wolfgang Abraham	Wolfgang Abraham
Yehoshua Neuwirth	Yehoshua Neuwirth
Yoshi Tatsu	Yoshi Tatsu
Yuasa Yoshiko	Yuasa
A. A. Milne	A. A. Milne
A. E. Housman	A. E. Housman
A. E. van Vogt	A. E. van Vogt
A. J. Ayer	A. J. Ayer
Aage Bohr	Aage Bohr
Aage Bohr	Aage Niels Bohr
Aaliyah	Aaliyah
Aaron	Aaron
Abbas II of Egypt	Abbas II of Egypt
Abbas Mirza	Abbas Mirza
Abd-ar-Rahman III	Abd-ar-Rahman III
Abd al-Rahman I	Abd al-Rahman I
Abd ar-Rahman II	Abd ar-Rahman II
Abd ar-Rahman V	Abd ar-Rahman V
Abdul Hamid I	Abdul Hamid I
Abdul Rashid Dostum	Abdul Rashid Dostum
Abdulaziz al-Omari	Abdulaziz al-Omari
Abdur Rahman Khan	Abdur Rahman Khan
Abdülaziz of the Ottoman Empire	Abdülaziz
Abel Tasman	Abel Tasman
Abner Doubleday	Doubleday
Abraham	Abraham the Jew
Abraham Lincoln	Abraham Lincoln
Absalon	Absalom
Abu Bakr	Abu Bakr
Abu al-Faraj al-Isfahani	Al-Isfahani
Ada Lovelace	Ada Lovelace
Adalbert of Prague	Adalbert of Prague
Adam Carolla	Adam Carolla
Adam Smith	Adam
Adam Weishaupt	Adam
Adelaide of Italy	Adelaide of Italy
Adin Steinsaltz	Adin Steinsaltz
Adolphe Sax	Adolphe Sax
Adrian Lamo	Adrian Lamo
Aeschylus	Aeschylus
Afonso III of Portugal	Afonso III of Portugal
Afonso II of Portugal	Afonso II of Portugal
Afonso IV of Portugal	Afonso IV of Portugal
Afonso I of Portugal	Afonso of Portugal
Afonso VI of Portugal	Afonso of Portugal
Afonso V of Portugal	Afonso of Portugal
Afonso de Albuquerque	Afonso de Albuquerque
Aga Khan I	Aga Khan
Aga Khan III	Aga Khan
Agatha Christie	Christie
Agatha Christie	Agatha Christie Ltd.
Agner Krarup Erlang	Agner Krarup Erlang
Agnes of Merania	Agnes of Merania
Agnes of Rome	Agnes of Rome
Agrippina the Elder	Agrippina the Elder
Agrippina the Younger	Agrippina the Younger
Ahab	Ahab
Ahmad Shah Durrani	Abdali
Ahmad Shah Massoud	Ahmad Shah
Ahmed I	Ahmed I
Ahmed II	Ahmad II
Ahmed III	Ahmed III
Ahmed al-Haznawi	Ahmed al-Haznawi
Ahmed al-Nami	Ahmed al-Nami
Ahuitzotl	Ahuitzotl
Aimery of Cyprus	Amalric II of Jerusalem
Akio Morita	Akio Morita
Akira Kurosawa	Akira Kurosawa
Akira Toriyama	Akira Toriyama
Akira Toriyama	Wonder Island
Akira Toriyama	Toccio the Angel
Akira Toriyama	Pola & Roid
Al Capone	Al Capone
Al Capone	Mae Capone
Al Capp	Al Capp
Alain Connes	Alain Connes
Alan Ayckbourn	Alan Ayckbourn
Alan Ayckbourn	Virtual Reality (play)
Alan Garner	Alan Garner
Alan Jay Lerner	Alan Jay Lerner
Alan Kay	Alan Kay
Alan Turing	Ture
Alaric I	Alaric I
Albert, Duke of Prussia	Albrecht of Brandenburg
Albert Alcibiades, Margrave of Brandenburg-Kulmbach	Albert Alcibiades, Margrave of Brandenburg-Kulmbach
Albert Brooks	Albert Brooks
Albert Camus	Albert Camus
Albert Einstein	Albert Einstein
Albert Frederick, Duke of Prussia	Albert Frederick, Duke of Prussia
Albert III, Duke of Saxony	Albert III
Albert Pike	Albert Pike
Albert Schweitzer	Albert Schweitzer
Albert Sidney Johnston	General Johnston
Albert Spalding	Albert Spalding
Albert Speer	Albert Speer
Albert the Bear	Albert the Bear
Alberto Giacometti	Alberto Giacometti
Alberto Giacometti	Giacometti
Albertus Magnus	Albertus Magnus
Alboin	Alboin
Albrecht Dürer	Durer
Alcuin	Albinus
Aldona of Lithuania	Aldona
Aldous Huxley	Aldous Huxley
Aleister Crowley	To Mega Therion
Aleksandr Solzhenitsyn	Aleksandr Solzhenitsyn
Alessandro Algardi	Alessandro Algardi
Alessandro Allori	Alessandro Allori
Alessandro Volta	Alessandro
Alex Lifeson	Alex Lifeson
Alexander Agassiz	Alexander Emanuel Agassiz
Alexander Fleming	Alexander Fleming
Alexander Graham Bell	AGB
Alexander Grothendieck	Alexander Grothendieck
Alexander III of Russia	Emperor Alexander
Alexander III of Scotland	Alexander III of Scotland
Alexander III of Scotland	Cultural depictions of Alexander III of Scotland
Alexander II of Scotland	Alexander II of Scotland
Alexander II of Scotland	Cultural depictions of Alexander II of Scotland
Alexander I of Scotland	Alexander I of Scotland
Alexander I of Scotland	Cultural depictions of Alexander I of Scotland
Alexander I of Serbia	Alexander I of Serbia
Alexander Jagiellon	Alexander Jagiellon
Alexander Jannaeus	Alexander Jannaeus
Alexander Kerensky	Alexander Kerensky
Alexander Mackenzie	Alexander Mackenzie
Alexander Selkirk	Selkirk
Alexander the Great	Alexander the Great
Alexander the Great	Alexandrian Empire
Alexei Petrovich, Tsarevich of Russia	Alexius
Alexei Petrovich, Tsarevich of Russia	Tsarevich Alexei Petrovich of Russia
Alexey Pajitnov	Alexey Pajitnov
Alexios III Angelos	Alexios Angelos
Alexios I Komnenos	Alexios I Komnenos
Alexios V Doukas	Emperor Alexius
Alexis Carrel	Alexis Carrel
Alexis Korner	Alexis Korner
Alfons Maria Jakob	Alfons Maria Jakob
Alfonso Cuarón	Alfonso Cuarón
Alfonso III of Aragon	Alfonso III of Aragon
Alfonso IV of Aragon	Alfonso IV of Aragon
Alfonso V of Aragon	Alfonso V of Aragon
Alfonso XIII of Spain	Alfonso XIII of Spain
Alfonso XII of Spain	Alfonso, Prince of Asturias
Alfonso the Battler	Alfonso the Battler
Alfred Hitchcock	Alfred Hitchcock
Alfred Jarry	Alfred Jarry
Alfred Korzybski	Korzybie
Alfred Lawson	Alfred Lawson
Alfred Nobel	Nobel
Alfred Russel Wallace	Alfred Russel Wallace
Alfred the Great	Alfred the Great
Alhazen	Alhazen
Allan Dwan	Allan Dwan
Allen Ginsberg	Ginsberg
Alois Alzheimer	Alzheimer
Alp Arslan	Alp Arslan
Alvar Aalto	Alvar Aalto
Alvar Aalto	Hugo Alvar Henrik Aalto
Alvin Toffler	Alvin Toffler
Amalasuntha	Amalasuntha
Amalric of Bena	Amalric
Amalric of Jerusalem	Amalric
Ambrose	Ambrose
Ambrose of Alexandria	Ambrose of Alexandria
Ambrosius Bosschaert	Ambrosius Bosschaert
Amerigo Vespucci	Americus
Amitabh Bachchan	Amida
Amos Bronson Alcott	Amos Bronson Alcott
Amr Diab	Amr Diab
Amy Grant	Amy Grant
Amyntas III of Macedon	Amyntas III of Macedon
Amyntas I of Macedon	Amyntas I of Macedon
Ananda	Ananda
Anastasios II	Anastasios II
Anastasius I Dicorus	Anastasius I Dicorus
Anatole France	Anatole France
Anatoly Karpov	Karpov
Anaxagoras	Anaxagoras
Anaximander	Anaximander
Anaximenes of Miletus	Anaximenes of Miletus
Anaïs Nin	Nin
Ancus Marcius	Ancus Marcius
Anders Celsius	Anders Celsius
Andre Agassi	Andre
Andrei Sakharov	Andrei Sakharov
Andrei Tarkovsky	Andrei Tarkovsky
Andrei Tarkovsky	Concentrate (screenplay)
Andrew Carnegie	Andrew Carnegie
Andrew II of Hungary	Andrew II
Andrew Jackson	Andrew Jackson
Andrew Johnson	Andrew Johnson
Andrew Tridgell	Tridge
Andrew Wiles	Andrew Wiles
Andrey Markov	Andrei Markov
Andronikos III Palaiologos	Andronicus
Andronikos II Palaiologos	Andronicus
Andronikos I Komnenos	Andronikos I
Andrzej Sapkowski	Andrzej Sapkowski
André-Marie Ampère	Ampere
André Gide	Andre Gide
André Weil	André Weil
André the Giant	André the Giant
Andy Warhol	Andy Warhol
Angilbert	Angilbert
Ani DiFranco	Ani DiFranco
Anita Hill	Anita Hill
Ann Druyan	Ann Druyan
Ann Widdecombe	Ann Widdecombe
Anna Kournikova	Anna Kournikova
Anne Brontë	Bronte
Ansgar	Ansgar
Anthony Hopkins	Stella Arroyave
Anthony Hopkins	Anthony Hopkins
Anthony of Saxony	Anthony of Saxony
Anthony the Great	Anthony the Great
Antipope Boniface VII	Antipope Boniface VII
Antipope John XXIII	Antipope John
Antoine Lavoisier	Lavoisier
Antoine Thomson d'Abbadie	Antoine Thomson d'Abbadie
Anton Chekhov	Anton Chekhov
Anton Drexler	Anton Drexler
Antoninus Pius	Antoninus
Antonio Canova	Antonio Canova
Apollos	Apollos
Apuleius	Apuleius
Arabian Prince	Arabian Prince
Arcadius	Arcadius
Archduke Charles, Duke of Teschen	Archduke Charles
Archimedes	Archimedes
Ardal O'Hanlon	O'Hanlon
Ariel Sharon	Arik
Ariel Sharon	Lily Sharon
Aristide Maillol	Aristide Maillol
Aristophanes	Aristophanes
Aristotle	Aristotle
Arlo Guthrie	Arlo Guthrie
Arnold Schwarzenegger	Arnold Schwarzenegger
Arnulf of Carinthia	Arnulf of Carinthia
Aron Nimzowitsch	Aaron Nimzovich
Aron Nimzowitsch	Aron Nimzowitsch
Arthur Aikin	Arthur Aikin
Arthur Eddington	Arthur Eddington
Arthur J. Stone	Arthur Stone
Arthur Jensen	Arthur Jensen
Arthur Laurents	Arthur Laurents
Arthur Miller	Arthur Miller
Arthur Phillip	Arthur Phillip
Arthur Schopenhauer	Arthur Schopenhauer
Arthur Schopenhauer	Schopenhauer's criticism of the proofs of the parallel postulate
Arthur St. Clair	Arthur St. Clair
Arthur Wellesley, 1st Duke of Wellington	Arthur Wellesley
Arthur William à Beckett	Arthur William a Beckett
Ashoka	Asok
Athanasius of Alexandria	Athanasius of Alexandria
Atle Selberg	Atle Selberg
Attila	Attila
Attila	Attila the Hun
August Derleth	August Derleth
August Horch	August Horch
August Kekulé	Kekule
August Kekulé	Friedrich August Kekule von Stradonitz
Auguste Rodin	Auguste Rodin
Augustin-Jean Fresnel	Augustin-Jean Fresnel
Augustin-Louis Cauchy	Augustin-Louis Cauchy
Augustine of Hippo	Augustine of Hippo
Augustine of Hippo	St. Augustine
Augustus	Sebaste
Aung San Suu Kyi	Aung San Suu Kyi
Aurel Stein	Aurel Stein
Axayacatl	Axayacatl
Ayn Rand	Ayn
B. F. Skinner	B. F. Skinner
Babe Ruth	Babe
Babe Ruth	Babe Ruth Birthplace Museum
Babrak Karmal	Babrak Karmal
Babur	Babur
Bal Thackeray	Bal Thackeray
Barb Wire	Barb wire
Barbara Olson	Barbara Olson
Barnabas	Barnabas
Barry Bonds	Barry Bonds
Barry Goldwater	Barry Goldwater
Baruch Spinoza	Baruch Spinoza
Barış Manço	Barıs
Batman	Batman (comics)
Batman	Matches Malone
Bayezid I	Bayezid I
Bayezid II	Veli
Beatrix Potter	Beatrix Potter
Bede	Bede
Bela Lugosi	Bela Lugosi
Bela Lugosi	Béla Lugosi
Ben Bova	Ben Bova
Benedict of Nursia	Benedict of Nursia
Benjamin D. Santer	Santer
Benjamin Disraeli	Benjamin Disraeli
Benjamin Franklin	Benjamin Franklin
Benjamin Lee Whorf	Benjamin Lee Whorf
Benny Andersson	Benny Andersson
Benoit Mandelbrot	Benoit Mandelbrot
Benoit Mandelbrot	Benoit Mandelbrot
Bernard Montgomery	Bernard Law Montgomery
Bernard Montgomery	Bernard Montgomery, 1st Viscount Montgomery of Alamein
Bernard of Clairvaux	Clairvaux
Bernie Federko	Bernie Federko
Berry Berenson	Berry Berenson
Bert Bell	Bert Bell
Berthe Morisot	Berthe Morisot
Bertrand Andrieu	Bertrand Andrieu
Bertrand Russell	Bertrand Russell
Big Brother (Nineteen Eighty-Four)	Big Brother (Nineteen Eighty-Four)
Bilge Khagan	Bilge Khagan
Bill Atkinson	Bill Atkinson
Bill Bixby	Bill Bixby
Bill Bryson	William Bryson
Bill Clinton	BJC
Bill Gates	Wikipedia:Help desk/Archive 21
Bill Haley	Jack Haley
Bill Joy	Bill Joy
Bill Macy	Bill Macy
Bill Mumy	Bill Mumy
Bill Oddie	Bill Oddie
Bill Schelter	Bill Schelter
Bill Walsh (American football coach)	Bill Walsh
Bill Watterson	Bill Watterson
Bille August	Bille August
Billy Bob Thornton	BBT
Billy Crystal	Billy Crystal
Bing Crosby	Bing Crosby
Bing Crosby	Bing Crosby Productions
Bjarne Stroustrup	Bjarne Stroustrup
Björn Borg	Bjorn Borg
Björn Ulvaeus	Bjoern Ulvaeus
Bjørn Lomborg	Bjørn Lomborg
Blaise Pascal	Amos Dettonville
Blaise Pascal	Blaise Pascal
Blind Blake	Blind Blake
Blind Lemon Jefferson	Blind Lemon Jefferson
Blind Willie McTell	Blind Willie McTell
Blythe Danner	Blythe Danner
Bo Diddley	Bo Diddley
Bob Costas	Costas
Bob Hawke	Bob Hawke
Bob Knight	Bob Knight
Bob Wills	Bob Wills
Bob Young (businessman)	Bob Young (businessman)
Bobby Charlton	Robert Charlton
Bodhidharma	Bodhidharma
Bohdan Khmelnytsky	Bohdan Khmelnytsky
Boris Pasternak	Boris Pasternak
Boston Corbett	Boston Corbett
Boudica	Boadicea
Bram Stoker	Dracula's Castle
Brian Aldiss	Brian Aldiss
Brian Boitano	Brian Boitano
Brian De Palma	Brian De Palma
Brian Kernighan	Brian Kernighan
Brian Lara	Brian Lara
Brigitte Bardot	Brigitte Bardot
Brion Gysin	Brion Gysin
Britney Spears	Adnan Ghalib
Britney Spears	Brit
Britney Spears	Sean Preston Federline
Brownie McGhee	Brownie
Bruce Campbell	Bruce Campbell
Bruce Perens	Bruce Perens
Bruce Sterling	Bruce Sterling
Bruno of Querfurt	Bruno of Querfurt
Buckminster Fuller	Buckminster Fuller
Bud Selig	Bud Selig
Buddy Holly	Buddy Holly
Bumin Qaghan	Bumin Qaghan
Burhanuddin Rabbani	Rabbani
Burt Lancaster	Burt Lancaster
C. L. Moore	C. L. Moore
C. Northcote Parkinson	C. Northcote Parkinson
C. S. Forester	C. S. Forester
C. S. Lewis	Clive Lewis
Caitlin Clarke	Caitlin Clarke
Caligula	Caligula
Calista Flockhart	Calista Flockhart
Calvin Coolidge	Calvin Coolidge
Calvin Coolidge	Calvin Coolidge, Jr.
Calvin and Hobbes	Calvinball
Camilla Hall	Camilla Hall
Camille Pissarro	Camille Pissarro
Camille Pissarro	Le Quai Malaquais et l'Institut
Captain America	Captain America
Captain America	Captain America
Captain America	Captain America Comics
Carl Barks	Carl Barks
Carl Friedrich Gauss	Carl Friedrich Gauss
Carl Linnaeus	Carl Linnaeus
Carl Menger	Carl Menger
Carl Rogers	Carl Rogers
Carl Sagan	Mister X
Carl von Clausewitz	Carl von Clausewitz
Carlo Collodi	Carlo Collodi
Carlo Goldoni	Carlo Goldoni
Carlos Valderrama	Carlos Valderrama
Carol Kane	Carol Kane
Carolyn Beug	Carolyn Beug
Cary Elwes	Cary
Casimir III the Great	Casimir III of Poland
Casimir III the Great	Casimir
Catherine Coleman	Catherine Coleman
Catherine of Aragon	Catherine of Aragon
Catherine of Siena	Saint Catherine of Siena Parish School
Causantín mac Cináeda	Constantine I
Ceawlin of Wessex	Ceawlin of Wessex
Cecil B. DeMille	Blount
Cecilia Beaux	Cecilia Beaux
Cem Karaca	Karaca
Cesare Borgia	Cesare Borgia
Chaim Topol	Chaim Topol
Charlemagne	Gisela
Charles Alston	Charles Alston
Charles Babbage	Charles Babbage
Charles Baudelaire	Charles Baudelaire
Charles C. Krulak	Charles C. Krulak
Charles Dickens	Charles Dickens
Charles Edward Jones	Charles Jones
Charles Evans Hughes	Justice Hughes
Charles Evers	Charles Evers
Charles F. Hockett	Charles F. Hockett
Charles Farrar Browne	Charles Farrar Browne
Charles Farrar Browne	Artemus Ward
Charles I of England	Charles I
Charles Lyell	Lyell
Charles Martel	Martel
Charles Martel	Rotrude of Trier
Charles Messier	Charles Messier
Charles Mingus	Mingus
Charles Proteus Steinmetz	Steinmetz
Charles Robert Malden	Charles Robert Malden
Charles Tupper	Tupper
Charles Williams (British writer)	Charles Williams (British writer)
Charlie Chaplin	Charlie
Charlize Theron	Charlize Theron
Charlotte Brontë	Brontëan
Chet Atkins	Chet Atkins
Chiang Kai-shek	Jieshi
Chris Cunningham	Chris Cunningham
Chris Marker	Chris Marker
Chris Morris (satirist)	Chris Morris
Chris Sarandon	Chris Sarandon
Christiaan Barnard	Christiaan Barnard
Christian Doppler	Christian Doppler
Christian Goldbach	Christian Goldbach
Christine Lavin	Christine Lavin
Christine de Pizan	Christine de Pizan
Christoph Ludwig Agricola	Christoph Ludwig Agricola
Christopher Columbus	Colombo
Christopher Guest	Christopher Guest
Christopher Marlowe	Christopher
Chuck D	Chuck D
Chuck Jones	Chuck Jones
Chuck Yeager	Chuck Yeager
Clara Petacci	Clara Petacci
Clarence Brown	Clarence Brown
Clark Ashton Smith	CAS
Clark Kent	Clark Kent
Claude Auchinleck	Claude Auchinleck
Claude Louis Berthollet	Claude Louis Berthollet
Claude Monet	Monet
Claude Piron	Piron
Claude Shannon	Claude Shannon
Claudius	Claudius
Clement Attlee	Clement Attlee
Clement Martyn Doke	Clement Martyn Doke
Clement of Alexandria	Clement of Alexandria
Clive Anderson	Clive Anderson
Fanny Kaplan	Fanni Kaplan
Farah Pahlavi	Farah Pahlavi
Farhad Aslani	Farhad Aslani
Farhad Darya	Nasher
Faria Alam	Faria Alam
